1111111111
1C00C0CP01
1CE0000111
1C00C0C001
1C00C0C001
1C00C0C001
1C00C0C001
1111111111