1111111111
1C00C0CP01
1CE0C10111
1CC0C0C011
1C000X00C1
1111111111