11111111111
1000P00E001
1C0001C0001
100C00000X1
11111111111