1111111111
1PCE000C01
1PCE000C11
1111111111