1111111111
1P00000C01
1C000E0001
1003230133
1111111111