1111111111
10E0000011
1PCCCCCCE1
10000X00C1
1111111111