1111111
10P00E1
10XC001
1111111
