1111111111
10E0000011
1PCCCCCCE1
10000X0001
1111111111